111111111111111111111111111111111111111111111111111111111111
100000C0000000000C000000000000X000000000001000001000C000X001
1000000000C0000000000000000011111110000000100C00100000000001
1000C0000000000C000C000X000010000011111111100000100C00000001
1000C0000C0000000000000000001000000000000000000000000000X001
100000C00000000000000000000C11111110000000000000000000000001
100000C0000000CC00000000000000C00000000000C00001111111111111
100000000000000000000000000X0000000000000000000000000000X001
1000X0000E000000000C0000000000000C000000000000010000000X0001
100000000000000C0000000X000000000000000000000001000C00000001
100000000C000000000000000000000000000000000000010000000C0001
10000C0000000000X000000000000000000C0000000P0001000000000001
1000000000X00000000000000000001000000000C000000100X000C00001
100C000100C000X0000000000C0000100000X00000000001000000000001
10000001000000000000X00000000010000000000X000001000000C00001
100C00010000C000000000000000001000000000C0000001000X00000001
100000010000000000000X000000001000000000X000C0010000000C0001
100C0001000000X000000000000000100000000000000001000000000001
100000010000000000000000001111111110000000X000010000000X0001
10000001000X000000X000000000001000000000000000010000C0000001
100C000100000000000000000X0000100000000000000001000000000001
100000000000000C00000X000000001000000000000000010000X0000001
1000000000X00000000000000000001000000000000000010000000C0001
100000000010000000000000X00000111111111111000001000000000001
10000X000010000000000000000C000000000000010000010000C0000001
100000000011111111111000000X0000000000X001000001000000000001
1000000000100000000000000000000000000000010000010000X00C0001
10000X0000X00000001000001111C1000000000001000001000000000001
1000000000100000000X0000100000X0000000X0010000100C0000X00001
100000000010000000000100100000000000000001000001000000000001
1000000000100000000000000000000X00000000000000010000000X0001
111111111111111111111111111111111111111111111111111111111111