11111111111111111111111111111111
10000000000000000000000000000001
10000000000000C0000000000C000001
100000000000P0000000000000000001
100010C0000000000000000000000001
1000111111110000000000000C000001
100000000001000000C0000000000001
1000000000010000000000000E000001
11111111111111111111111111111111




