11111111111111111111111111111111
10000010000000000000000000000001
10000010000000C0000110000C000001
100000100000P0000000000000000001
100000C0000000000000000000000001
1000111111110000000011110C000001
100000000001000000C0000100000001
1000000000010000000000010E000001
11111111111111111111111111111111




