1111111111111111111
1000000000000000001
1000000000000000001
100000000000P000001
100000C000000000001
1000000000000000001
10000000000000E0001
1111111111111111111

