11111111111111111111111111111111
10000010000000000000000C00000001
100C0010000000C00001100000000001
100000100000P0000000000000000001
10000000000000C000000000000C0001
10001111111100000000111100000001
100000000001000000C0000100E00001
10000000000100000000000100000001
11111111111111111111111111111111




