11111111111111
1X00E00P00C001
11111111111111