11111111111111
100CE00P000X01
11111111111111