11111111111111
10EC000P00X001
11111111111111