111111111111111111111111111111111111111111
100000100000000000000000000000000000000001
100000100000000000011000000000000000000001
100000100000P00000000000000000000000000001
100000000000000000000000000000000000000001
100011111111000000001111000000000000000001
100000000001000000C00001000000000000000001
100000000001000000000001000000000000000001
100000000001000000000001000000000000000001
1000000000010000000000010000000E0000000001
100000000001000000000001000000000000000001
111111111111111111111111111111111111111111